1111111111111111
111C0000000000E1
1111111111110011
11C0001111110001
11111000000000C1
1111100111111111
11P0000000000C11
1111111111111111
