11111111111111111111
100000000000000000E1
10011111111111111001
1P000000000000000001
11111111111111111111
