11111111111111111111
1E0000000000000000E1
10011111111111111001
1P0000000000000000C1
11111111111111111111
