11111111111111111111111111111111111
1C00011110000000111111000000C1111E1
11110000001111101111110111111111101
11111111001110000000000111111111101
10000000001C001111111100000011C0001
1P0001100C1111C00000000011100000111
11111111111111111111111111111111111
