11111111111111111111
100000000000000000E1
00011111111111111001
1P0000000000000000C1
11111111111111111111
