11111111111111111111
100000000000000001E1
10011111111111111111
1P0000000000000000C1
11111111111111111111
