1111111111111111
11111111111010E1
1111111111110011
1111111111110001
1111111111110001
1111111111111111
1111111111111111
1111111111111111
1111100111111111
1111100111111111
1111100000000001
111C000000011001
1111111111111001
1000000000000001
1P001100000000C1
1111111111111111
