1111111111111111
1111111111101001
1111111111110011
1111111111110001
1111111111110001
1111111111111111
1111111111111111
1111111111111111
1111100111111111
1111100111111111
1111100000000001
1110000000011001
1111111111111001
1000000000000001
1000110000000001
1111111111111111
